##########################################################################################################################################################
                                        D   I      F         I  a  D               F    a              b             g                                   #
#######################################################################################################################################################  #
   g  #  Da #     # g  be     #           #        #              #        #                 #           #     #     #             bb I          ee   #  #
#  #  #  #  #  ####  #######e #ee#######  #  ####  #  ####  ####  #  ####  ####  ##########  #  #  ####  #  #  #h #  #  #########################  ####  #
#  #  F  #  #  D  #  #     #  #  #        #  #     #C    #     #  #  #        #  #        #  #  #  #  #     #     #  #        #        #  I     #     #  #
####ee####  ####  #cc#  #  #  #  ####  ####  #  #############  ####  #  ####  #  #  #######  #  #  #  #############  ##########  ####  #  ####  ####  #  #
#     #   aa#  g  #  #  #     #     #  #     #  #     #        #     #  #  #     #  #   C    #  #  #  #     #     #     #     #     #e    # C#        #  #
#bb####hh####  ####  #  #ee#######  ####  ####g #  #  #  ####  #  #### C#  #######  #  #######  #  #  #  #  #  #  ####  #  #  ####gb#######  #  #######  #
#     #    F e #     #  #  #     #     #  #     #  #     #     #     #           #  #  a  #   d #  #  #  #     #        #  #     #        #  #     #  #  #
####hh#############aa####  ####  ####  #  #  ####  #######  #######  ##########  #  ####  #######  #  #  ####  ################  ####  #  #  ####  #  #  #
#   aa#  #   b    #     #  #     #     #  #        #     #  #     #   h #F    #  #  h     #        #     #  #  #   a    #     #  #     #  #     #  #  #  #
#  ####hh#cc####hh####cc#cc#######  #  ##########  #  #  ####  #### h#  #  #############  #############  #  #  #  ####  #  #  #######  ####  #  #  #F #  #
#  #        #  a        #  #  #  #     #     #     #  #       g   #     #  #     #       g#    C#           #     #        #h #        #     #  #  #  #  #
#cc#aa#######gg##########hh#  #  #  #######  #  #  #  #############  ##########  #  ####  ####  #  #########################  #######  ####  #  #  #  #  #
#  #        #  #     C b   #   d g  #     #  #  #  #      b #   a       #     #  #  #     #     #          F#                       #     #     #g    #  #
#  ####ee#cc####  #############hh#### g####  #  #  #######  #######  #  #  #  #  #  #  ####  #############  #############  #######  ####  ##########  #  #
#   g    #  b  #         b          b     #  #  #  #        #        #  #  #     # b#    C      #        #                 #     #        #     I   e #F #
#############  #########################  #  #  #  #  #######  #######  #  #######  # a#######  #  ####  ###################  #  ################  ####  #
#  b        #cc# I F    #                 #  #  #  #     #     #h    #     #        #  #        #     #  b        #           #  #          d#        #  #
#  #######hh#  #  ####  ####  #############  #  #  ####  #  ####  #  ####  #  #######  #  ##########  ##########  #############  #  #  ####  #  #######  #
#  g    F#     #     #  #     #        #     #  #     #  #     #  #  #  #  # C#     #  #     #        #     #    g               #  # I#     #  #     #  #
####hh#ee#############cc#  ####  ####  #  #  #######  #  ####a ####  #  #  #  #  ####  ####  #  ####  #  #  #  ###################a #  #  ####  #  #  # b#
#     #  #  I  #  D  #  #  # b   #  g  g  #     #     #  #  #     #  #     #  #  h     #     #  #  C  #  #  #     # F   #        #  #  #  #     #  #  #  #
#  ####hh#  #  #  #  #  #  #  ####  #  #######  #  ####  #  ####  #I #  #  #  ########## I####  #  ####  #  ####  #  #  #  ####  #  #  #  #  #######  #  #
#  #     #  #  #  #  a  #     #     #        #     #  #  #  #        #  #     #     #  #        #     #  #  #     #  #  #     #     #aF#     #     #  #  #
####  #######  # e#############  ##########  #######  #  #  #  ################  #  #  ####  #######  #  #  #######  #  #### d#######  #######  #  #  #  #
#  b  #  a e#     #        #  #  #        #  e  #        #  #     #     #        #  #    d   #   d #     #     #     #        #        #        #  #  #  #
#  ####  #  #cc####  ####  #  #  #  #### I####  #  #  ####  ####  #  #  ##########  ####  ####d #############  #  #  ##########  #######  #  ####  #  #  #
#  #  b  #  #   I    #     #     #     #  #     #  #     #  #     #  #           #     #     #  #              #  #        #  #        #F #     # h#  #  #
#  #  ####  ####  ####  #############  #  #  ####  ####  #  #  #############  #  ####  ####  #  #  #############  #######  # b#######g #  ####  #  #  #h #
#cc#  #     #     #     #        #     #  #  #     #     #  # b   #           #  #  #     #     #           #     #e #     #           #  #  #  #     #  #
#d #  #  ####  ####  ####  ####  #  ####  #  #  ####  ####  #  #  #  ####  ####  #  ####  ################  #  ####  #  ################  #  #  # a####  #
#  #ee#   g    #        #     # e#     # C   #  #           #  #    e#     #I #  F  #     #           #  #  #  #     # d   #g F           # I#  #     #  #
#  #  ####  ##########  #  #  #  #  ##########  #  ##########  #######  #  #  #######  ####  #######  #  #  #  #  #######  ################  #  ####  #  #
#        #  #      F #     #  #I #     #        #                 #     #  #     #C #  # a   #  #     #     #     #  F  #                    # h# b   # b#
#######  ####  ####  ##########  ####  ###################  #######  ##########  #  #  ####  #  #  ####  ##########  #  #############  #######  #  ####  #
#     #     #     #     #        #  #  # gg  #   d       #  #  #     #                    #     #     #     #  #     #     #        #  #F    #  #  #  #  #
#  #  ####  #  #######  #  #######  #  #  #  ####  ####### I#  #  #############  #  ####  ##########  ####  #  #  ##########  #  ####  #  #  #  #  #  #  #
#  #  #     #  #        #        #  #a #  #     #  e     #I #  #  #     e     #  #  #              #     #  #    a      #     #  I     #  # d   #     #  #
#  #  #######  #  ####  #######  #  #  #  ####  #######  #  #  # F#  #######  ####  #  ##########  ####  #  #  #######  #  #  ##########  ########## d#  #
#  #  #     #  #  #  #    F      # a#  #  #     #  #     #     #  #  #     #     #  #  #     #     #     #  #     b  #   I #      C    #  #  #        #  #
#  #  #  #  ####C # F#############  #  #  #  ####  #  ##########  #  #  #  ####  #  ####  #  #######  ####  ######################  #  #  #  #  ####### h#
#  #  # I#        #    e         # a#  #  #     #  #C       #  #  #     # d#     #        #  #     #g    #  #     #           #  #  #  #  #     #     #  #
#  ####  ##########  ####  ####  #d #  #  ####  #  #######  #  #  ##########  #############  #  #F ####  #  #  # b#  #######  #  #  #### C#######  #  #  #
#  #     # h         #  #  h  #  #  # h#  #     #        #        #           #              #  #     #a #  #  # d#  #     #  #   h #  IC #        #  #  #
#  #  ####  ##########  ####  #  #  #  #  #h ####  ####  #  #######g ##########  #############  ####  #  # C#  # I#  ####b #  #  ####  ####  #######  #  #
#     #     #        #  #     # d   #  #  #   e # C   #  #        #     # b   #  #              #     #  #     #   F #       a#  #  #  #     #       C#  #
#######  ####  ####  #  #F #######  #  #  ####  #######  #############  ####  #  ################  ####  #############  #######  #  #  ####  #  #######  #
#     #    F   #     # e         #  # g#  #  # I      #                 #     #           #           #     #       e   #        #        #  #     #  #  #
#  #  ##########  #############  #F #b #  #  #h ####  #  ################  #############  #  ####  #######  #  ####  ####  #############F #  ####  #  #  #
#  #              #           #  #     #  #  #  #     #  #        # g         #        #        #  #        #     #  #     #           #  #     #     #  #
#  ################  ##########  #######  #  ####  #  #  ####### h####### d#  #######  #######  #  #  ##########  # C#  ####  ##########  #  #  #######  #
#        #        #  #           #     #  #        #  #  #     #           #     #  #      b    #  #  b     #     #  #h #a #              #  #  #    C#  #
#######  #  ####  #  ####  #######  #  #  #############  #  #  ################  #  #############  #######  #######  #  #  #############  ####  #  #  #  #
#     #  #  #     #                 #  #     #        #  #  #  #     #        #                 #              #  #  #  #        #       g      #  #  #  #
#  #  #  #  ####  #######  #######  #  ####  #  ####  #  #  #  #  #  #  ####  ################  ##########  #  #  #  #  #  ####  #  ####  #######  #  #  #
#  #  #  #I    #        #     #     #  # a   #  #     #     #     #     #     #     #      F    #     #     #  #  #           #     #     #        #  #  #
#  #  #  ####  #############  #  ####  #  ####  ################  #######  ####  #  #######  ####  #  #  ####  #  ##########  #######  ####  #######  #  #
#  #     #  d     #           #     #        #  #           #  #  #     #     #  # F         #     #  #     #  #        #  a  #        #a    #        # I#
#  #######  ####  #  #############  #######  #  #  #######  #  #  #  #  ####  #  ##########  #  ####  #######h #  ####  #  #  #  ####### C#  #  #######  #
#           #     #  #     #     #     #     #     #   d   F#        #     #  #  #      I #  #  #     #     Id #     #a    #  #        #  #  #    d   #  #
############# g####  ####  #  #######  #  ##########  ##########  #######  ####  #  ####  ####  #######  ##########  #######  #######  #  #  #  ####  #  #
#     #        #  #        #     #     #           #        #  # I   #  #     #  #  #     #I          #  #           #     #        # h#  #  #     #  #  #
####  #  #######  #############  #  ####  #######  #######  #  ####  #  ####  #  #  #  ####  #  #  ####  #d ####  #######  #######  #  ####  ####  #  #  #
#        #     #        #     #     #     #     #        #  #g #     #  #     #     #    h   #  #        #  #  #       a   #     # d#        #     # h#  #
#  ##########  #  ####  #a #  #############  #  ##########  #  # a####  #  ##########  #######  ##########  #  ####  #######  ####  ##########  #######  #
#  #       g#  #     #  # I#           #  #  #  F  #    a#        #     #  #     #  # I   #     #      b #  #     #  #           #     #     #        #  #
#  #  ####  #  #######  #  ##########  #  #  ####  #  #  ####  ####  ####  #  #  #b #  #  ##########  ####  #  #  #  ##########  ####  #  #  #######  #  #
#  #  #        #        #     #        #    g   #d    #     #     #     # I#  #  #     #       baI    #     #  #  #     #     #     #  #  #  #     #  #  #
#  #  #  #######  #######  ####  #########################  ####  ####  #  #  #  ##########  ##########  #######  ####  #  #  ####  #  ####I #  #  #  #  #
#  #  #  #        #        #     #              #  F  #h #        #           #  #    h      #    I   #  #     a  #     #  #        #I #     #  #     #  #
#  #  ####  # F####  #######  ####  ##########  ####  #  ##########  ####  #######  ################  #  #  ##########  #  ##########  #  #############  #
#        #  #  #     #     #        #           #     #     #     #     #     #     #     #         a #     #     #     #  #     #  #          F#  g  # C#
####  #  #  ####  ####  #  ##########  ##########  #######  #  #######  #### C#  ####  #  #  #############  #  #  #F ####  #  #a #  ####  ####  #  #  #  #
#     #     #     #     #              #     #        #     #        #    C#  #  #     #     #     #  #     #  #     #a    #  #  #       C#     #  #  #  #
#  ##########  ####  ####  #############  ####  #  #  #  #  #######  ####  #  #  #  #############  #  #  ####  #######  #######  ##########  ####  #  #  #
#     #           # C   #  #  #        #        #  #     #     #   h       #  #  #        #        #     #  #  #              #  #     #     #     #  #  #
#  #  #d #######  ####  #  #  #  ####  ####  ####  ##########  #  #  #######  #  #######  #  #######  #  #  #  #  ####  ####  #  #  ####  ####  ####  #  #
#  #     #        #     #     #  #  #  h  #     #           #  #  #        #  #     #     #  #      h #  #  #     #   C #     #  #     #     #   a #  #  #
#  #######  ###################b #  #  #  ################  ####  #######  #  ####  #  #  #  #############  #######  ####  ####  ####  ####  #F #  #  #I #
#  #     #     #                 #  #  #     #     #     #        #        #  #     #  #  #     C  #        #  #     #  #  #     #  #        #  #  #  #  #
####  #  ####  #  #############  #  #######  #  #  #  #############  #######  #I ####  ##########  #g #######  #  ####  #  #  ####  ####  #######  #  #  #
#     #  #     #  #           #  #  #e    #  #  #F #b #        #     #           #        #     #  #  #  #        #g     h #     #  #     #        #  #  #
#  ####  #  #######  #######  #  #  #  #  #  ####  #  #  ####  #  ####  ##########  ####  ####  #e #  #  #  ###################  #  #  ####  #######  #  #
#     #     #     #     #    e#  #     #  #  #     #  #  #  #  #  #     #        #  #  #     #    h   #  #     #              C  #  #        #        #  #
####F #######  #b #######  ##########  #e #  #  ####  #  #  #d #  #  ########## d#  #  #  #  ####  ####  ####  #  ################  ##########  ####### g#
#I #           #     #     #        #  #        #        #     #  #  #        #     #  #F #   I #     #     #  #    a#     # g      #     #  #        #  #
#  ################  #  ##########  #  ##########  ################  #######  #  ####  #######  ####  ####  #  ####  #  #  #  #######  #  #C #######  #  #
#      h                #     #     # b   #           #        #              #  #  #        #  #  #     #        #  #  #  #     #     #     #     #  #e #
#  ################  #######  #  ####  #  #  ####  #  #  #  #  #  #  ##########  #  #######  # F#  ####  ####  #  #  ####  ####  #  #  #######  #  #  #  #
#           #     #b       #     #     #  #  #     #  #  #  #     #              #     #  #  #        #    e   #  #     #  #   b #  #  #        #  #  #  #
##########  #  #######  #  ####  #  #######  #  ####  #  #  ######################  # d#  #  #  ################d ####  #  #  ####  #  #  #######  #  #  #
#           #          g#     #  # a#e    #  #     #     #     #        #     #  #  #  C  #     #     #        #  #     #  #  #   e #     #        #  #  #
#  #########################  #  #  #  #  #  ####  ##########  #  ####  #  #  #  #  ####  ####  #  #  #  ####  ####h #  #  #  #  ##########  ####  #  #  #
#       e      #                    #F #        #  #     #  d  #  #        #  #     #     a  #     #        #     #  #  #  #     #           #     #  #  #
#############  #  ##########  #  ####g #  ####  #  #  #  #  #######  #  ####  #############  ##########  #######  #a #  #  ################### g####  #  #
#  #        #  #  #     #     #        #     #  #  #  #  #     #     #  b  #     #        # d         #  #     #  # C#     #        #  #     #     #  #  #
#  #  ####  #  #  #### a#  ################  #  #  #  #######  #  #############  #  #############  #  ####  #  #  #  #  ####  ####  #  #  #  ####  #  #  #
#     #        #        #  F  # b      #     #  #  #        #     #     #     #  #  #     F        #        #     #  #     #  #     #  #  #        #  #  #
############################  #  ####  #  ####  #  ####  ####  #######  #  ####  #  #  #  ################### g####  ####  #  #  ####  #  ##########  #  #
#                             #  d  #     #     #   C # d  eC           # d      # C   #                    #        #        #           #              #
##########################################################################################################################################################
