##########################################################################################################################################################
                                                                                                                                                         #
#######################################################################################################################################################  #
   #        #     #  #                    #     #              #     #     #     #           #     #  #              #                    #        #  #  #
#  #######  #  #  #  #  #######  #######  ####  #  #######  #  ####  ####  #  ####  #######  #  #  #  #  ##########  #  ################  #  ####  #  #  #
#     #  #  #  #     #  #        #        #     #  #        #     #        #     #  #  #     #  #        #        #  #  #     #        #  #     #     #  #
####  #  #  #  ####  ####  #######  #######  ####  #  ##########  #######  #  #  #  #  #  ####  #  #######  ####  #  #  ####  #  ####  #  ####  #######  #
#  #     #  #     #     #  #  #     #     #  #     #           #        #  #  #        #  #     #              #  #  #        #  #     #  #  #     #  #  #
#  #  #  #  ####  ####  #  #  #  ####  #  #  #  ##########  #  #######  #  #############  #  ###################  #  #  #######  #######  #  ####  #  #  #
#  #  #           #     #  #  #        #  #     #     #     #     #     #              #  #  #        #     #     #  #  #        #     #  #     #  #  #  #
#  #  ####  #######  ####  #  ##########  #  ####  #  #  #######  #  ################  #  #  #  ####  ####  #  #######  #  #  ####  #  #  ####  #  #  #  #
#  #  #     #        #  #  #     #        #  #     #     #     #  #  #           #     #  #  #  #  #     #  #        #     #     #  #  #     #  #     #  #
#  ####  #  #  #######  #  ####  #######  #  #############  #  #  #  #  #######  #  ####  #  #  #  ####  #  #######  #  #######  ####  ####  #  #  ####  #
#  #     #  #  #           #        #  #  #        #     #  #  #  #  #  #  #        #     #  #  #        #        #  #  #     #  #        #  #  #  #  #  #
#  #  #######  ####  #######  ####  #  #  #######  ####  #  #  #  #  #  #  #  #######  #######  ####  ##########  #  #  #  #  #  #  #######  #  #  #  #  #
#     #        #     #        #  #        #  #     #        #  #  #     #     #        #        #     #        #  #        #  #  #     #     #  #     #  #
#######  #######  ####  #######  ##########  #  ####  #  ####  #######  #######  #  ####  ###################  #  #############  ####  #  ####  ####  #  #
#     #     #     #           #  #        #  #  #     #     #     #     #        #  #  #                    #  #                 #     #  #        #  #  #
#  #  ####  #  #############  #  #  ####  #  #  #  #############  #  ####  #######  #  #  ################  #  ###################  ####  #  ####  #  #  #
#  #        #  #              #  #     #     #  #        #     #  #        #     #  #  #  #        #        #     #           #     #     #  #        #  #
#  ##########  #  #############  #  #  #######  #######  #  #  #############  ####  #  ####  #######  ####  #  #  ##########  ####  #  ####  ####  ####  #
#  #     #     #                 #  #  #     #  #     #  #  #     #     #                    #     #     #  #  #              #     #        #     #  #  #
#  #  #  #  ######################  #  #  #  #  #  #  #  #  ####  ####  #  ################  #  #  ####  #  #  #############  #  #############  #  #  #  #
#     #  #  #     #           #     #  #  #  #  #  #     #     #     #  #              #     #  #     #  #  #        #     #        #           #  #  #  #
#######  #  #  #  ####  ####  #  ####  ####  #  #  #######  #######  #  #############  #######  ####  #  #  #######  #  #  ####  #  #  ##########  #  #  #
#        #  #  #           #  #     #     #  #     #        #     #  #              #        #  #     #  #           #  #        #  #  #        #     #  #
#  #######  #  ##########  #  ##########  #  #  #############  #  #  #############  #######  #  #  ####  #############  #######  ####  #  ####  #  ####  #
#  #        #     #     #  #  #        #  #  #  #        #     #        #        #        #  #  #  #     #           #        #     #  #  #     #     #  #
#  #  #  #######  #  #  ####  #  ####  #  #  #  #  ####  #  #######  #  #  ####  ####  ####  #  #  ##########  #############  ####  #  #  #  #######  #  #
#     #        #  #  #  #           #  #  #  #  #     #  #  #        #     #     #  #        #  #                          #     #  #  #  #     #     #  #
#  #############  #  #  #  #  #######  #  #  #  #  ####  #  #  #############  ####  ##########  #########################  #######  #  #  #######  ####  #
#  #              #  #     #  #     #        #     #        #  #     #     #  #        #        #              #        #           #  #  #           #  #
#  #  #############  #######  #  #  ####  ##########  #  ####  #  #  #  #  #  #######  #  #######  ##########  #  ####  #############  #  #  #######  #  #
#     #              #     #     #     #  #     #  #  #  #     #  #     #  #           #        #        #     #  #  #  #        #     #  #  #        #  #
#######  ##########  #  #  ##########  #  #  #  #  #  #  #  ####  ####  ##########  ####  ####  ##########  #  #  #  #  #  ####  #  ####  #  #  #######  #
#     #  #        #  #  #  #     #     #     #     #  #  #        #     #           #     #           #     #     #  #  #     #        #     #  #     #  #
####  #  #######  ####  #  ####  #  #  ##########  #  #  ##########  ####  ##########  #############  #  ##########  #  ####  #######  #######  ####  #  #
#     #     #  #  #     #        #  #  #        #  #  #  #     #     #        #     #     #     #        #        #        #  #        #        #     #  #
#  #######  #  #  #  ####  #######  #  #######  #  #  #  #  #  #  ##########  ####  #######  #  #  #  ####  #  #############  #  #######  #######  #  #  #
#  #     #  #  #  #  #  #  #        #  #        #     #  #  #     #        #           #     #  #  #     #  #     #           #  #     #  #        #  #  #
#  #  ####  #  #  #  #  #  ##########  #  #############  #  #######  ####  ##########  #  ####  #######  #  ####  #  ##########  ####  #  #  #######  #  #
#  #  #     #     #  #  #  #        #  #     #           #        #     #  #     #     #     #        #     #     #     #     #     #  #  #     #     #  #
#  #  #  #  #  ####  #  #  #  ####  #  ####  ####  #######  ####  ####  #  ####  #  #######  #######  ####  #  #######  ####  ####  #  #  #######  #  #  #
#  #     #  #  #     #  #     #     #  #  #     #  #     #  #  #     #  #        #     #     #     #  #     #     #     #     #        #  #        #  #  #
#  #######  #  #  ####  #######  #  #  #  ####  #  #  #  #  #  ####  #  ####  #######  #  ####  #  #  #  #######  #  #  #  #######  ####  #  #######  #  #
#  #        #     #     #        #     #  #  #  #  #  #     #     #  #  #  #     #  #     #     #  #     #        #  #  #  #        #  #     #     #  #  #
#  #  #############  ##########  #  ####  #  #  #  #  ##########  #  #  #  ####  #  #######  ####  #######  #  #######  #  ##########  #######  #  #  #  #
#  #  #     #     #  #  #        #        #  #  #  #  #        #     #     #     #           #     #        #     #     #     #  #     #        #  #  #  #
#  #  #  #  #  #  #  #  #  ################  #  #  #  #  #  #  ##########  #############  ##########  #  #  ####  #  #######  #  #  #  #  #######  #  #  #
#     #  #     #  #     #              #        #  #     #  #        #  #        #     #              #  #     #  #  #     #  #     #     #           #  #
#######  #######  #  #  #######  ####  ####  #  #  #  #############  #  #######  ####  #########################  #  ####  #  #############  ##########  #
#     #  #     #     #        #     #        #  #  #     #              #     #           #                       #  #     #              #     #     #  #
#  ####  #  #  #############  #  ################  ####  #  #############  #  #######  #  #  ######################  #  ####  ##########  #######  #  #  #
#  #     #  #  #        #  #  #     #              #     #  #           #  #           #  #     #  #        #        #  #     #              #     #  #  #
#  #  ####  #  #  ####  #  #  ####  #  #######  ##########  #  #######  #  #############  ####  #  #  ####  #  #######  ###################  #  ####  #  #
#     #     #  #  #  #     #        #  #        #     #     #     #     #     #        #     #     #  #        #        #        #     #     #  #     #  #
#######  ####  #  #  ####  ##########  #  #######  #  ##########  #  #######  #  ####  ####  ####  #  ################  #  ####  #  #  #  ####  #  ####  #
#     #  #  #     #     #           #  #     #     #           #  #        #  #  #     #  #     #     #              #  #     #  #  #  #  #     #     #  #
#  #  #  #  #######  #  ##########  #  ####  #  #  ##########  #  #######  #  #  #  ####  ####  #######  ##########  #  ####  #  #  ####  #  #######  #  #
#  #  #  #  #  #     #     #     #     #  #     #  #           #     #  #  #     #           #  #     #  #        #  #     #  #  #     #  #        #  #  #
#  ####  #  #  #  #######  #  #  #######  ##########  #############  #  #  ###################  #  #  #  #  #######  #  #  #  #  #  #  #  #######  ####  #
#        #  #     #     #  #  #  #     #        #     #              #  #        #        #     #  #     #     #     #  #     #  #  #  #  #     #     #  #
#  #######  #######  #  #  #  ####  #  ####  #  #  #######  ##########  #######  #  ####  #  ####  ##########  #  #############  #  #  #  #  #######  #  #
#        #  #     #  #  #  #  #     #     #  #     #     #     #     #        #     #  #  #  #           #     #        #  #     #  #  #  #           #  #
#######  #  ####  #  #  #  #  #  #  ####  #  #######  #  ####  #  #  #######  #######  #  #  #  #######  #  #######  #  #  #  ####  #  #  #  #######  #  #
#        #     #  #  #  #        #  #     #     #     #  #     #  #  #           #     #        #     #  #  #        #     #  #     #  #  #        #  #  #
#  #######  #  #  #  #  ##########  #  #######  #  ####  #  ####  #  #  ####  #  #  #######  ####  #  ####  #  #############  #  ####  #  ##########  #  #
#     #     #        #  #     #  #  #        #  #  #        #     #  #  #     #     #        #  #  #     #        #     #     #     #  #     #        #  #
####  #  #######  ####  #  #  #  #  #######  #  #  ##########  ####  #  #  #######  #  #######  #  ####  ####  #  #  #  #  #######  #  ####  #  #######  #
#     #  #     #     #  #  #           #     #     #     #     #     #  #        #     #     #  #     #     #  #  #  #     #     #  #     #     #     #  #
#  ####  #  #######  ####  ##########  #  ##########  #  #  ####  ####  ####  #######  #  #  #  ####  ####  #  #  #  #######  #  #######  #  ####  #  #  #
#  #     #  #        #     #        #  #  #     #     #  #     #     #     #        #  #  #  #        #        #  #  #     #  #           #  #     #  #  #
#  #  ####  #  #  ####  ##########  ####  #  #  ####  #######  ####  ####  #######  #  #  #  ###################  #  #  ####  ####  #  ####  #  #######  #
#  #  #  #     #     #           #        #  #     #     #     #  #  #     #     #  #     #     #                 #  #        #     #  #     #        #  #
#  #  #  ##########  #  #######  ##########  ####  #  #  #  ####  #  #######  #  #############  #  ################  #######  #  #######  ##########  #  #
#     #              #     #     #        #     #     #     #  #     #        #           #     #                    #        #     #     #        #  #  #
#  #############  ##########  ####  #  #  ####  ##########  #  ####  #  ################  #  #######  ####  ##########  #######  #  #  #######  ####  #  #
#  #        #     #     #     #     #  #  #  #        #  #     #     #  #           #  #     #  #     #  #  #           #        #     #        #     #  #
#  #  ####  #  #######  #  ####  #######  #  #######  #  #######  ####  #  #######  #  #######  #  ####  #  ####  #######  #######  ####  #######  #  #  #
#  #     #  #  #        #  #        #     #  #     #  #        #  #  #     #        #  #        #  #     #  #     #           #     #     #     #  #  #  #
#  ####  ####  #  ####  #  ##########  ####  #  #  #  #  #  #  #  #  #######  #######  #  #######  #  ####  #  ####  #######  #  ####  ####  #  #  ####  #
#     #        #  #     #        #     #     #  #     #  #  #     #  #  #     #        #     #     #     #     #           #  #     #  #     #  #     #  #
####  ##########  #  ##########  #  ####  ####  ##########  #######  #  #  ####  #  ####  #  ####  ####  #  #############  #######  #  #  ####  ####  #  #
#     #        #  #     #     #  #        #     #        #        #  #  #     #  #     #  #     #        #     #     #        #     #  #     #     #  #  #
#  ####  #  #  #  ####  #  #  #  #  ####  #  ##########  #######  #  #  ####  #  ####  #  ####  #############  #  #  ####  #  #  ####  ####  ####  #  #  #
#        #  #  #  #  #     #     #  #     #           #        #     #        #  #     #  #  #                 #  #  #     #  #  #     #     #        #  #
##########  ####  #  #######  #  #  #  #############  #######  #######  #  ####  #  ####  #  ###################  #  #  #######  #  #############  ####  #
#  #     #  #     #     #     #     #              #  #     #           #     #  #  #     #  #        #     #     #     #        #  #     #        #  #  #
#  #  #  #  #  #######  #  #############  #######  #  #  ################  #  #  #  #######  #  ####  ####  #  ####  #######  ####  #  #  #  #######  #  #
#  #  #  #     #     #  #        #        #     #     #        #     #     #  #  #        #  #     #  #     #  #     #        #     #  #  #  #        #  #
#  #  ####  #######  #  ##########  ##########  #############  #  #  #  #######  #######  #  #######  #  ####  #######  #######  ####  #  #  #  #######  #
#  #        #        #              #     #     #                 #  #     #     #     #                 #        #  #        #     #  #     #  #     #  #
#  ####  #  #  #  #  ################  #  #  ####  #######  #######  #######  #  #  #######  #######  ####  #  #  #  #######  #  ####  #######  #  #  #  #
#  #     #  #  #  #     #     #        #     #     #  #     #        #        #  #        #  #     #        #  #     #     #  #     #     #     #  #  #  #
#  #  #######  #######  #  #  #  ####  #######  ####  #  #############  ################  #  #  #  ##########  ####  #  #  #  ####  ####  #  ####  #  #  #
#  #  #     #     #  #     #     #        #     #     #     #           #           #     #  #  #  #           #  #  #  #     #        #  #     #  #  #  #
#  #  #  #  ####  #  #############  ####  #  ####  #######  #  ##########  ##########  #######  #  #######  ####  #  #  #############  #  ####  #  #  #  #
#     #  #     #  #        #     #     #  #        #     #     #  #     #  #           #  #     #        #        #  #     #           #  #     #  #  #  #
#  ####  ####  #  #  ####  ####  ####  #  #######  #  ##########  #  #  #  #  ####  #  #  #  ##########  ##########  ####  #  ####  ####  #  ####  #  #  #
#  #     #  #     #  #     #     #     #     #  #  #  #        #     #        #     #     #  #        #        #  #  #     #  #  #  #              #  #  #
#  ####  #  #######  #  ####  #  #  #######  #  #  #  #  ####  ##########  ################  #  #  ##########  #  #  #  ####  #  #  #######  #######  #  #
#        #           #        #     #        #     #     #                                   #  #                    #        #              #           #
##########################################################################################################################################################
