##########################################################################################################################################################
                                                                                                                                                         #
#######################################################################################################################################################  #
   #           #     #              #     #                       #                    #        #  #     #                    #     #     #           #  #
#  ####  ####  #  ####  ##########  ####  #  #######  ##########  #  ####  ##########  #  ####  #  #  #  #  ####  ##########  #  #  #  #  #  #######  #  #
#     #  #        #     #     #        #  #        #           #     #  #     #        #     #  #     #  #  #  #  #        #     #  #  #  #  #     #  #  #
####  #  #  #######  ####  #  #  ####  #  #######  ##########  #######  ####  #######  #  ####  #  ####  #  #  #  #  ####  #######  #  #  ####  #  #  #  #
#     #  #        #  #     #  #  #  #  #        #  #        #  #     #     #  #     #  #     #  #  #     #  #     #     #     #     #  #  #     #     #  #
#  ####  #######  #  #  ####  #  #  #  #######  #  #  ####  #  #  #  #  #  #  #  #  #######  ####  #######  ##########  #  #  #  #######  #  ##########  #
#        #        #  #  #     #     #        #  #  #     #     #  #  #  #     #  #     #        #           #     #  #  #  #     #     #  #     #     #  #
##########  #######  ####  ################  #  #######  #######  #  #  #############  #  ####  #############  #  #  #  #  #######  #  #  ####  #  #  #  #
#     #     #     #                 #     #              #     #  #  #                 #     #     #           #     #  #  #     #  #        #     #  #  #
#  #  ####  #  #  ################  #  ###################  #  #  #  #######  #############  ####  ################  ####  ####  #  ####  #  #######  #  #
#  #        #  #     #        #  #  #        #              #  #  #  #        #           #  #     #                       #        #     #  #        #  #
#  ##########  #######  ####  #  #  #  ####  #  #############  #  #  #######  #  #######  ####  ####  ######################  #  ####  #######  #######  #
#        #  #              #        #  #     #  #              #  #  #     #  #     #  #     #              #           #     #     #     #     #     #  #
#######  #  #############  #######  #  #  ####  #  #############  #  #  #  #  ####  #  ####  #######  ####  #  #  ####  #  #######  #######  ####  #  #  #
#     #  #           #     #     #  #  #        #        #     #  #     #     #     #  #        #     #     #  #  #     #     #           #  #     #  #  #
#  #  #  ##########  #  ####  #  ####  ################  #  #  #  #  ##########  #  #  #######  #  #  #  #  #  #  #  ####  #  ##########  #  #  ####  #  #
#  #  #     #  #     #        #        #     #        #  #  #     #  #  #     #  #  #  #        #  #  #  #  #  #  #  #     #        #  #     #     #  #  #
#  #######  #  #  ######################  ####  ####  #  #  #######  #  #  #  #  ####  #  ##########  #  ####  ####  #  #  #######  #  ##########  #  #  #
#  #           #        #              #        #     #  #        #     #  #  #     #  #     #        #        #        #        #     #  #        #  #  #
#  #  #######  #  ####  #  ##########  ##########  ####  #######  #######  #  ####  #  ####  #  ##########  ####  #############  #  ####  #  #######  #  #
#     #        #     #  #  #        #  #     #        #  #     #  #     #  #  #     #        #     #     #  #  #              #  #        #  #  #     #  #
#######  #######  ####  #  #  ####  #  #  ####  ####  #  #  #  #  ####  #  #  #  #######  #######  ####  #  #  ################  ##########  #  #  ####  #
#     #           #     #  #  #     #  #     #  #     #  #  #  #  #     #  #        #     #     #     #        #     #           #        #  #     #  #  #
#  #  ##########  #  ####  #  #  #  #  ####  #  #######  #  ####  #  #  #  #######  #  ####  #  ####  #############  #  ##########  #######  ####  #  #  #
#  #              #        #  #  #        #  #           #  #     #  #     #  #     #     #  #     #     #     #        #        #           #  #     #  #
#  #########################  #  #######  #  #############  #  ####  #######  #  #  ####  #######  ####  #  #  #  #######  ####  #  #  #######  #######  #
#  #           #     #     #  #  #     #  #     #  #        #     #     #        #     #        #        #  #  #           #     #  #  #        #     #  #
#  #  #######  #  #  #  #  ####  #  #  #######  #  #  ####  ####  #  #  ####  #######  #######  #  #  #  #  ################  ####  #  #  ##########  #  #
#  #     #     #  #     #  #     #  #        #  #  #     #        #  #     #  #     #     #  #     #  #  #     #                    #  #        #     #  #
#  ####  #  ####  #######  #  ####  #######  #  #  ####  #  #############  #  ####  ####  #  ##########  ####  #  ##########  #############  #  #  ####  #
#     #  #        #     #  #     #  #        #        #  #     #           #     #  #     #  #           #     #     #     #              #  #     #  #  #
####  #  ##########  #  #######  #  #  #######  #######  #  ####  #############  #  #  ####  #  #######  #  #######  #  #  #############  #  #######  #  #
#  #     #           #           #  #  #        #     #  #        #     #     #     #     #  #  #        #  #  #     #  #  #           #  #           #  #
#  ##########  ###################  #  #  #  #######  #  ##########  #  #  #############  #  ####  #######  #  #  #######  ####  ####  #  #######  ####  #
#           #           #     #     #  #  #     #        #           #  #        #        #     #  #        #  #              #  #     #        #     #  #
##########  ##########  #  #  #  ####  #  ####  #  #  ####  ##########  #######  #  #  #######  #  #  #######  ##########  #  #  #  ##########  ####  #  #
#  #              #     #  #     #     #     #     #  #  #  #        #  #           #        #  #     #     #        #     #     #  #     #           #  #
#  #  ##########  #  ####  #######  #  ####  #######  #  #  #  ####  #  #  ####  #############  #######  #  #######  #  ##########  #  #  #  #  #######  #
#  #     #     #  #        #        #              #     #        #  #  #     #                 #     #  #     #  #     #        #  #  #  #  #        #  #
#  ####  ####  #  ##########  #########################  #######  #  #######  ###################  ####  ####  #  #######  ####  #  ####  #  ####  #  #  #
#  #        #     #     #     #     #           #        #  #     #        #     #     #        #        #              #     #  #     #  #  #     #  #  #
#  #  ####  #######  #  #  ####  #  #  #######  #  #######  #  ##########  #  #  #  #  #######  #############  #  ####  ####  #  ####  #  #  #  ####  #  #
#     #     #     #  #     #     #     #        #     #     #           #     #     #        #     #           #     #        #        #     #  #     #  #
#######  #######  #  ####  #  ##########  ##########  #  ##################################  #  ####  ####  #######  ####  ###################  #  ####  #
#     #              #     #        #  #  #     #  #     #                 #                 #     #     #  #  #     #     #              #     #  #  #  #
#  #  ###################  #######  #  #  ####  #  ################  #  ####  #######  ##########  #######  #  #  ####  ####  #############  ####  #  #  #
#  #           #        #  #        #  #        #        #           #     #     #  #     #     #        #  #     #     #  #     #        #  #  #  #  #  #
##########  #  #  ####  #  #  #######  ####  ####  #######  #############  ####  #  ####  #  #  #######  #  #  ####  ####  #  ####  ####  #  #  #  #  #  #
#        #  #     #  #        #        #        #        #  #        #  #  #     #     #  #  #     #     #  #     #     #           #  #     #  #     #  #
#  ####  #  #######  ####  ####  #######  #############  #  #  ####  #  #  #  #######  #  #  #  #  ####  #  ####  ####  #############  #######  #  ####  #
#     #     #        #  #     #           #     #     #  #  #     #  #  #  #  #        #     #  #     #  #     #     #              #  #        #     #  #
#  #  #######  #######  ####  #######  #######  #  #  #  #  ####  #  #  #  #  #  ################  #  #  ####  ####  ##########  #  #  #  #############  #
#  #     #     #     #     #  #                    #     #        #     #  #  #  #           #     #  #  #  #  #     #           #     #  #           #  #
#  #######  ####  #  ####  #  ###########################################  #  #  #######  #  #  ####  #  #  #  #  ####  ##########  ####  ####  ####  #  #
#  #  #        #  #     #     #                 #        #     #        #     #           #     #  #     #     #  #        #     #        #     #     #  #
#  #  #  #######  #  #  #######  ####  #######  #  ####  #  #  #  ####  #  #######  #############  #############  #  #  ####  #  ##########  #######  #  #
#     #  #     #  #  #        #  #     #        #     #     #  #  #  #        #     #        #        #           #  #  #     #           #        #  #  #
####  #  #  #  #  ##########  #  #######  ###################  #  #  ####  #  #  #######  ####  ####  ################  #  #############  #######  ####  #
#     #  #  #     #           #        #           #        #  #  #     #  #  #           #     #  #  #           #     #              #        #     #  #
#  ####  ##########  ################  ##########  #  ####  #  #  #  #  ####  #############  ####  #  #  #######  #  ###################  ####  #  #  #  #
#  #                 #              #  #        #     #     #  #  #  #  #     #     #        #  #     #        #  #        #     #     #  #     #  #  #  #
#  #  #############  #  ####  #######  #  ####  #######  ####  #  ####  #  ####  #  #  #######  #############  #  #  ####  #  #  #  #  ####  #######  #  #
#  #              #  #     #        #  #     #  #        #     #        #  #     #     #     #     #           #  #     #  #  #     #     #  #        #  #
#  ##########  ####  #  #  ####  #  #  ####  #  #  #######  #############  #  ##########  #  #  #  ####  #######  ####  #  #######  ####  #  #  #######  #
#        #     #     #  #     #  #     #     #  #  #        #                 #     #     #  #  #     #        #  #     #  #        #     #  #  #     #  #
#  #######  ####  ####  ####  ################  #  #  #######  #######  #  ####  #  #  ####  #  ####  ##########  #  ####  #  #######  ####  #  #  #  #  #
#           #  #     #     #  #        #     #  #     #     #  #     #  #        #  #  #     #  #  #              #  #  #     #        #     #  #  #  #  #
#############  ####  #######  #  ####  #  #  #  #######  ####  ####  #  ##########  #  #  ####  #  ################  #  #######  #######  ####  ####  #  #
#           #                 #  #     #  #  #        #        #     #     #  #     #  #        #           #        #     #     #     #  #           #  #
#  #######  #######  #############  #  #  #  #######  ##########  #######  #  #  ####  ###################  #  ####  ####  #  #######  #  #  #  #######  #
#        #  #     #              #  #  #  #  #        #     #  #     #     #     #     #              #     #  #  #     #  #  #        #  #  #     #  #  #
#  ####  #  #  ################  #  #  #  #  ####  #  ####  #  ####  #######  ####  ####  #  ####  #  #  ####  #  ####  #  #  #  #  ####  #######  #  #  #
#     #  #     #        #        #  #  #  #     #  #        #  #  #     #     #     #     #  #     #  #  #     #        #        #  #                 #  #
####  ##########  ####  #  #  ####  #  #  ####  #  ####  ####  #  ####  #  ####  ####  ####  #  ####  #  #######  ##########  #######  #  #############  #
#  #              #     #  #        #     #  #     #  #        #     #           #  #  #     #  #     #        #     #        #     #  #     #        #  #
#  ################  ################  ####  ####  #  #############  ####  #######  #  #  ####  ####  #######  ####  #  ##########  #  ####  #  #  #  #  #
#     #        #     #     #        #     #     #  #  #           #     #     #  #     #  #     #     #     #        #        #     #     #  #  #  #  #  #
####  #  ####  #  ####  #  #  #  #######  ####  #  #  #  #######  ####  ####  #  #######  #  ####  ####  #  ################  #  ##########  #  #  ####  #
#     #  #  #     #     #  #  #     #     #     #  #  #     #     #     #     #  #     #  #     #     #  #     #        #        #  #        #  #     #  #
#  #  #  #  #  ####  #  #  #######  ####  #  ####  #  ####  #######  ####  ####  ####  #  ####  ####  #  ####  #  #######  #  #  #  #  #  ##########  #  #
#  #  #  #  #     #  #  #     #           #        #     #     #              #     #  #     #     #     #     #           #  #     #  #  #           #  #
#  ####  #  ####  #  #######  #  #  #######  #######  #######  #  ##########  ####  #  ####  ####  #######  ################  #######  #  #  ##########  #
#     #     #  #     #     #     #  #        #        #     #  #  #  #           #  #  #  #     #     #     #        #        #        #              #  #
#  #  #######  #######  #  #######  #  #######  #######  ####  #  #  #  ####  #  #  #  #  #  #######  #######  ####  ##########  ##########  #######  #  #
#  #        #           #        #  #        #     #     #     #     #  #     #     #        #     #        #     #        #     #     #     #        #  #
#  #######  #  #  ################  #######  ####  #  ####  ##########  #  ###################  #  #######  ####  #######  #######  #  #  ####  #######  #
#  #     #  #  #     #     #        #  #     #           #        #     #           #           #           #     #     #        #  #     #  #  #     #  #
####  #  #  #######  #  #  #  #  ####  #  #############  #######  #  #############  #  ######################  ####  #######  ####  #######  #  #  ####  #
#     #  #  #           #     #     #     #     #              #  #     #        #  #        #        #           #  #        #     #     #     #     #  #
#  ####  #  #  ####  #############  #  ####  #  #  ##########  #  ####  #  ####  #  #######  #  ####  #  ##########  #  #  ####  ####  #  #  #######  #  #
#     #  #     #  #     #     #     #     #  #  #  #        #  #  #     #     #        #     #  #  #     #        #  #  #     #        #  #        #  #  #
#  #  ##########  ####  #  #  #############  #  #  #  ####  #  #  #  #######  ##########  ####  #  ####  #  ####  #  #  ####  ##########  #######  #  #  #
#  #           #        #  #           #     #     #  #     #  #  #  #     #              #     #        #  #  #  #     #  #     #           #        #  #
#  ##########  #  #######  ##########  #  #  #######  ##########  #  ####  #########################  ####  #  #  #######  ####  #############  #  ####  #
#  #        #     #     #  #     #  #     #  #     #           #  #     #  #           #  #           #  #     #  #           #     #     #     #     #  #
#  #  ####  #######  #  #  #  #  #  #  ####  #  ####  #######  #  ####  #  ####  ####  #  #  ##########  #######  #  #######  ####  #  #  #  #######  #  #
#  #     #  #        #     #  #  #  #     #  #        #           #     #        #     #        #     #     #     #  #     #           #           #  #  #
#  ####  #  #  ################  #  ####  #  ####  ####  ####  ####  #############  ####  ####  #  #######  #  #  #  #  #  #######  #######  ####  #  #  #
#        #  #                    #        #        #     #                                #     #              #     #  #           #        #     #     #
##########################################################################################################################################################
