##########################################################################################################################################################
                                                                                                                                                        #
#######################################################################################################################################################  #
      #     #     #           #           #        #              #        #                 #           #     #     #                                #  #
#  #  #  #  #  ####  #######  #  #######  #  ####  #  ####  ####  #  ####  ####  ##########  #  #  ####  #  #  #  #  #  #########################  ####  #
#  #     #  #     #  #     #  #  #        #  #     #     #     #  #  #        #  #        #  #  #  #  #     #     #  #        #        #        #     #  #
####  ####  ####  #  #  #  #  #  ####  ####  #  #############  ####  #  ####  #  #  #######  #  #  #  #############  ##########  ####  #  ####  ####  #  #
#     #     #     #  #  #     #     #  #     #  #     #        #     #  #  #     #  #        #  #  #  #     #     #     #     #     #     #  #        #  #
#  ####  ####  ####  #  #  #######  ####  ####  #  #  #  ####  #  ####  #  #######  #  #######  #  #  #  #  #  #  ####  #  #  ####  #######  #  #######  #
#     #        #     #  #  #     #     #  #     #  #     #     #     #           #  #     #     #  #  #  #     #        #  #     #        #  #     #  #  #
####  #############  ####  ####  ####  #  #  ####  #######  #######  ##########  #  ####  #######  #  #  ####  ################  ####  #  #  ####  #  #  #
#     #  #        #     #  #     #     #  #        #     #  #     #     #     #  #        #        #     #  #  #        #     #  #     #  #     #  #  #  #
#  ####  #  ####  ####  #  #  #######  #  ##########  #  #  ####  ####  #  #  #############  #############  #  #  #  ####  #  #  #######  ####  #  #  #  #
#  #        #           #  #  #  #     #     #     #  #           #     #  #     #        #     #           #     #        #  #        #     #  #  #  #  #
#  #  #######  ##########  #  #  #  #######  #  #  #  #############  ##########  #  ####  ####  #  #########################  #######  ####  #  #  #  #  #
#  #        #  #           #        #     #  #  #  #        #           #     #  #  #     #     #           #                       #     #     #     #  #
#  ####  #  ####  #############  ####  ####  #  #  #######  #######  #  #  #  #  #  #  ####  #############  #############  #######  ####  ##########  #  #
#        #     #                          #  #  #  #        #        #  #  #     #  #           #        #                 #     #        #           #  #
#############  #########################  #  #  #  #  #######  #######  #  #######  #  #######  #  ####  ###################  #  ################  ####  #
#           #  #        #                 #  #  #  #     #     #     #     #        #  #        #     #           #           #  #           #        #  #
#  #######  #  #  ####  ####  #############  #  #  ####  #  ####  #  ####  #  #######  #  ##########  ##########  #############  #  #  ####  #  #######  #
#        #     #     #  #     #        #     #  #     #  #     #  #  #  #  #  #     #  #     #        #     #                    #  #  #     #  #     #  #
####  #  #############  #  ####  ####  #  #  #######  #  ####  ####  #  #  #  #  ####  ####  #  ####  #  #  #  ###################  #  #  ####  #  #  #  #
#     #  #     #     #  #  #     #        #     #     #  #  #     #  #     #  #        #     #  #     #  #  #     #     #        #  #  #  #     #  #  #  #
#  ####  #  #  #  #  #  #  #  ####  #  #######  #  ####  #  ####  #  #  #  #  ##########  ####  #  ####  #  ####  #  #  #  ####  #  #  #  #  #######  #  #
#  #     #  #  #  #     #     #     #        #     #  #  #  #        #  #     #     #  #        #     #  #  #     #  #  #     #     #  #     #     #  #  #
####  #######  #  #############  ##########  #######  #  #  #  ################  #  #  ####  #######  #  #  #######  #  ####  #######  #######  #  #  #  #
#     #     #     #        #  #  #        #     #        #  #     #     #        #  #        #     #     #     #     #        #        #        #  #  #  #
#  ####  #  #  ####  ####  #  #  #  ####  ####  #  #  ####  ####  #  #  ##########  ####  ####  #############  #  #  ##########  #######  #  ####  #  #  #
#  #     #  #        #     #     #     #  #     #  #     #  #     #  #           #     #     #  #              #  #        #  #        #  #     #  #  #  #
#  #  ####  ####  ####  #############  #  #  ####  ####  #  #  #############  #  ####  ####  #  #  #############  #######  #  #######  #  ####  #  #  #  #
#  #  #     #     #     #        #     #  #  #     #     #  #     #           #  #  #     #     #           #     #  #     #           #  #  #  #     #  #
#  #  #  ####  ####  ####  ####  #  ####  #  #  ####  ####  #  #  #  ####  ####  #  ####  ################  #  ####  #  ################  #  #  #  ####  #
#  #  #        #        #     #  #     #     #  #           #  #     #     #  #     #     #           #  #  #  #     #     #              #  #  #     #  #
#  #  ####  ##########  #  #  #  #  ##########  #  ##########  #######  #  #  #######  ####  #######  #  #  #  #  #######  ################  #  ####  #  #
#        #  #        #     #  #  #     #        #                 #     #  #     #  #  #     #  #     #     #     #     #                    #  #     #  #
#######  ####  ####  ##########  ####  ###################  #######  ##########  #  #  ####  #  #  ####  ##########  #  #############  #######  #  ####  #
#     #     #     #     #        #  #  #     #           #  #  #     #                    #     #     #     #  #     #     #        #  #     #  #  #  #  #
#  #  ####  #  #######  #  #######  #  #  #  ####  #######  #  #  #############  #  ####  ##########  ####  #  #  ##########  #  ####  #  #  #  #  #  #  #
#  #  #     #  #        #        #  #  #  #     #        #  #  #  #           #  #  #              #     #  #           #     #        #  #     #     #  #
#  #  #######  #  ####  #######  #  #  #  ####  #######  #  #  #  #  #######  ####  #  ##########  ####  #  #  #######  #  #  ##########  ##########  #  #
#  #  #     #  #  #  #           #  #  #  #     #  #     #     #  #  #     #     #  #  #     #     #     #  #        #     #           #  #  #        #  #
#  #  #  #  ####  #  #############  #  #  #  ####  #  ##########  #  #  #  ####  #  ####  #  #######  ####  ######################  #  #  #  #  #######  #
#  #  #  #        #              #  #  #  #     #  #        #  #  #     #  #     #        #  #     #     #  #     #           #  #  #  #  #     #     #  #
#  ####  ##########  ####  ####  #  #  #  ####  #  #######  #  #  ##########  #############  #  #  ####  #  #  #  #  #######  #  #  ####  #######  #  #  #
#  #     #           #  #     #  #  #  #  #     #        #        #           #              #  #     #  #  #  #  #  #     #  #     #     #        #  #  #
#  #  ####  ##########  ####  #  #  #  #  #  ####  ####  #  #######  ##########  #############  ####  #  #  #  #  #  ####  #  #  ####  ####  #######  #  #
#     #     #        #  #     #     #  #  #     #     #  #        #     #     #  #              #     #  #     #     #        #  #  #  #     #        #  #
#######  ####  ####  #  #  #######  #  #  ####  #######  #############  ####  #  ################  ####  #############  #######  #  #  ####  #  #######  #
#     #        #     #           #  #  #  #  #        #                 #     #           #           #     #           #        #        #  #     #  #  #
#  #  ##########  #############  #  #  #  #  #  ####  #  ################  #############  #  ####  #######  #  ####  ####  #############  #  ####  #  #  #
#  #              #           #  #     #  #  #  #     #  #        #           #        #        #  #        #     #  #     #           #  #     #     #  #
#  ################  ##########  #######  #  ####  #  #  #######  #######  #  #######  #######  #  #  ##########  #  #  ####  ##########  #  #  #######  #
#        #        #  #           #     #  #        #  #  #     #           #     #  #           #  #        #     #  #  #  #              #  #  #     #  #
#######  #  ####  #  ####  #######  #  #  #############  #  #  ################  #  #############  #######  #######  #  #  #############  ####  #  #  #  #
#     #  #  #     #                 #  #     #        #  #  #  #     #        #                 #              #  #  #  #        #              #  #  #  #
#  #  #  #  ####  #######  #######  #  ####  #  ####  #  #  #  #  #  #  ####  ################  ##########  #  #  #  #  #  ####  #  ####  #######  #  #  #
#  #  #  #     #        #     #     #  #     #  #     #     #     #     #     #     #           #     #     #  #  #           #     #     #        #  #  #
#  #  #  ####  #############  #  ####  #  ####  ################  #######  ####  #  #######  ####  #  #  ####  #  ##########  #######  ####  #######  #  #
#  #     #        #           #     #        #  #           #  #  #     #     #  #           #     #  #     #  #        #     #        #     #        #  #
#  #######  ####  #  #############  #######  #  #  #######  #  #  #  #  ####  #  ##########  #  ####  #######  #  ####  #  #  #  #######  #  #  #######  #
#           #     #  #     #     #     #     #     #        #        #     #  #  #        #  #  #     #        #     #     #  #        #  #  #        #  #
#############  ####  ####  #  #######  #  ##########  ##########  #######  ####  #  ####  ####  #######  ##########  #######  #######  #  #  #  ####  #  #
#     #        #  #        #     #     #           #        #  #     #  #     #  #  #     #           #  #           #     #        #  #  #  #     #  #  #
####  #  #######  #############  #  ####  #######  #######  #  ####  #  ####  #  #  #  ####  #  #  ####  #  ####  #######  #######  #  ####  ####  #  #  #
#        #     #        #     #     #     #     #        #  #  #     #  #     #     #        #  #        #  #  #           #     #  #        #     #  #  #
#  ##########  #  ####  #  #  #############  #  ##########  #  #  ####  #  ##########  #######  ##########  #  ####  #######  ####  ##########  #######  #
#  #        #  #     #  #  #           #  #  #     #     #        #     #  #     #  #     #     #        #  #     #  #           #     #     #        #  #
#  #  ####  #  #######  #  ##########  #  #  ####  #  #  ####  ####  ####  #  #  #  #  #  ##########  ####  #  #  #  ##########  ####  #  #  #######  #  #
#  #  #        #        #     #        #        #     #     #     #     #  #  #  #     #              #     #  #  #     #     #     #  #  #  #     #  #  #
#  #  #  #######  #######  ####  #########################  ####  ####  #  #  #  ##########  ##########  #######  ####  #  #  ####  #  ####  #  #  #  #  #
#  #  #  #        #        #     #              #     #  #        #           #  #           #        #  #        #     #  #        #  #     #  #     #  #
#  #  ####  #  ####  #######  ####  ##########  ####  #  ##########  ####  #######  ################  #  #  ##########  #  ##########  #  #############  #
#        #  #  #     #     #        #           #     #     #     #     #     #     #     #           #     #     #     #  #     #  #           #     #  #
####  #  #  ####  ####  #  ##########  ##########  #######  #  #######  ####  #  ####  #  #  #############  #  #  #  ####  #  #  #  ####  ####  #  #  #  #
#     #     #     #     #              #     #        #     #        #     #  #  #     #     #     #  #     #  #     #     #  #  #        #     #  #  #  #
#  ##########  ####  ####  #############  ####  #  #  #  #  #######  ####  #  #  #  #############  #  #  ####  #######  #######  ##########  ####  #  #  #
#     #           #     #  #  #        #        #  #     #     #           #  #  #        #        #     #  #  #              #  #     #     #     #  #  #
#  #  #  #######  ####  #  #  #  ####  ####  ####  ##########  #  #  #######  #  #######  #  #######  #  #  #  #  ####  ####  #  #  ####  ####  ####  #  #
#  #     #        #     #     #  #  #     #     #           #  #  #        #  #     #     #  #        #  #  #     #     #     #  #     #     #     #  #  #
#  #######  ###################  #  #  #  ################  ####  #######  #  ####  #  #  #  #############  #######  ####  ####  ####  ####  #  #  #  #  #
#  #     #     #                 #  #  #     #     #     #        #        #  #     #  #  #        #        #  #     #  #  #     #  #        #  #  #  #  #
####  #  ####  #  #############  #  #######  #  #  #  #############  #######  #  ####  ##########  #  #######  #  ####  #  #  ####  ####  #######  #  #  #
#     #  #     #  #           #  #  #     #  #  #  #  #        #     #           #        #     #  #  #  #        #        #     #  #     #        #  #  #
#  ####  #  #######  #######  #  #  #  #  #  ####  #  #  ####  #  ####  ##########  ####  ####  #  #  #  #  ###################  #  #  ####  #######  #  #
#     #     #     #     #     #  #     #  #  #     #  #  #  #  #  #     #        #  #  #     #        #  #     #                 #  #        #        #  #
####  #######  #  #######  ##########  #  #  #  ####  #  #  #  #  #  ##########  #  #  #  #  ####  ####  ####  #  ################  ##########  #######  #
#  #           #     #     #        #  #        #        #     #  #  #        #     #  #  #     #     #     #  #     #     #        #     #  #        #  #
#  ################  #  ##########  #  ##########  ################  #######  #  ####  #######  ####  ####  #  ####  #  #  #  #######  #  #  #######  #  #
#                       #     #     #     #           #        #              #  #  #        #  #  #     #        #  #  #  #     #     #     #     #  #  #
#  ################  #######  #  ####  #  #  ####  #  #  #  #  #  #  ##########  #  #######  #  #  ####  ####  #  #  ####  ####  #  #  #######  #  #  #  #
#           #     #        #     #     #  #  #     #  #  #  #     #              #     #  #  #        #        #  #     #  #     #  #  #        #  #  #  #
##########  #  #######  #  ####  #  #######  #  ####  #  #  ######################  #  #  #  #  ################  ####  #  #  ####  #  #  #######  #  #  #
#           #           #     #  #  #     #  #     #     #     #        #     #  #  #     #     #     #        #  #     #  #  #     #     #        #  #  #
#  #########################  #  #  #  #  #  ####  ##########  #  ####  #  #  #  #  ####  ####  #  #  #  ####  ####  #  #  #  #  ##########  ####  #  #  #
#              #                    #  #        #  #     #     #  #        #  #     #        #     #        #     #  #  #  #     #           #     #  #  #
#############  #  ##########  #  ####  #  ####  #  #  #  #  #######  #  ####  #############  ##########  #######  #  #  #  ###################  ####  #  #
#  #        #  #  #     #     #        #     #  #  #  #  #     #     #     #     #        #           #  #     #  #  #     #        #  #     #     #  #  #
#  #  ####  #  #  ####  #  ################  #  #  #  #######  #  #############  #  #############  #  ####  #  #  #  #  ####  ####  #  #  #  ####  #  #  #
#     #        #        #     #        #     #  #  #        #     #     #     #  #  #              #        #     #  #     #  #     #  #  #        #  #  #
############################  #  ####  #  ####  #  ####  ####  #######  #  ####  #  #  #  ###################  ####  ####  #  #  ####  #  ##########  #  #
#                             #     #     #     #     #                 #        #     #                    #        #        #           #              #
##########################################################################################################################################################
